A  ###            #########   
##     ##########         # # 
## ############## ####### # # 
## #   #   ##          ## #   
#  #   # # ## ######## ## # ##
# ## # # #    # #   ## ## # ##
# #  # # ###### # # ## ## # ##
# # ## # #####  # # ## ## # ##
# #    #     ## # #    ## # ##
# ########## #### ####### #   
#      #   # ##   #    #  # # 
###### # # # ## ######## #  # 
###### #   # ##       ## #####
       ##### ######## ##     #
 ########    #    #   ###### #
 #      # ####### # ######## #
 #      #       # #       ## #
 # ############ # ####### ## #
 # #    #     # ######### ## #
 ### ## # ### #        ## ## #
     ## # #   ######## ## ## #
####### # # ########## ##    #
#  #    # # #       ## ##### #
#  # #### # # ##### ##   ###  
#  # #    # # ##### ####  ### 
# ## # #### #    ## ## ##  ## 
# #  #      #### ## ##  ##    
# # #########  # ## #### #### 
# #          ### ##    ###### 
############     #####       B